111111111111111111111111
100000000000000000000001
100000000000000001111111
1X00E000000000X000000001
10000000000000CCC0000001
1000X000C00000000000C111
100000000000000000000001
1X0000PC000000000C000001
111111111111111111111111
