111111111
10000E001
1P0000001
111111111
1000C0111
111111111