111111111
10000C001
1P0000001
111111111
10000E111
111111111