11111111111111111111
10000000000000000000
1P000000000E00000001
100000000000000C0001
11111111111111111111