11111111111111111111
10000000000000000001
1P000000000000000001
100000000000000C0001
111111111110000000C1
111111000C0000000001
10000000000000000001
1CC00000000000000001
100000000000000P0001
10000CCC000000000001
100000000E0000000001
11111111111111111111