11111111111111111111
1000000000000C000001
1P000000000000000001
11111111111111111111