111111111
100000001111
111CP00E1
111111111
