11111111
10PCE001
10000001
11001111
  11